GREEK	LINEAR_B
αγγελος	𐀀𐀐𐀫
αγεεν	𐀀𐀐
αγει	𐀀𐀐
αγειρειν	𐀀𐀐𐀩
αγειρω	𐀀𐀐𐀩
αγετερες	𐀀𐀐𐀳𐀩
αγορα	𐀀𐀒𐀨
αγοραια	𐀀𐀒𐀨𐀊
αγοραιος	𐀀𐀒𐀨𐀊
αγρευθεν	𐀀𐀐𐀩𐀄
αγρευς	𐀀𐀐𐀩𐀄
αγρεϝα	𐀀𐀐𐀩𐀷
αγρεϝανδε	𐀀𐀐𐀩𐀷
αγρεϝιος	𐀀𐀐𐀩𐀹𐀍
αγρος	𐀀𐀒𐀫
αγω	𐀀𐀐
αδαμαο	𐀀𐀅𐀔𐀃
αδαμας	𐀀𐀅𐀔𐀃
αδαμευς	𐀀𐀅𐀕𐀸
αδαμεϝεις	𐀀𐀅𐀕𐀸
αδινϝατας	𐀀𐀇𐁅𐀲
αδραστιος	𐀀𐀅𐀨𐀴𐀍
αεθιστος	𐀀𐀁𐀴𐀵
αελιποτας	𐀀𐀁𐀪𐀦𐀲
αθαμανευς	𐀀𐀲𐀔𐀚𐀄
αθαμας	𐀀𐀲𐀔𐀚𐀄
αια	𐁁𐀷𐀊
αιασμενα	𐀀𐀊𐀕𐀙
αιασμενος	𐀀𐀊𐀕𐀙
αιγα	𐁁𐀼
αιγαι	𐁁𐀼
αιγευς	𐁁𐀐𐀄
αιγινοος	𐁁𐀑𐀜𐀃
αιγιπατας	𐁁𐀑𐀞𐀲
αιγιπως	𐁁𐀑𐀡
αιγιἁλια	𐀀𐀑𐁀𐀪𐀊𐀆
αιγιἁλιανδε	𐀀𐀑𐁀𐀪𐀊𐀆
αιγιἁλιος	𐁁𐀑𐁀𐀪𐀍
αιγυπτιος	𐁁𐀓𐀠𐀴𐀍
αιζα	𐁁𐀼
αιζαι	𐁁𐀼
αιθαλευς	𐁁𐀲𐀩𐀄𐀯
αιθαλευσι	𐁁𐀲𐀩𐀄𐀯
αιθαλοϝεις	𐁁𐀲𐀫𐀸
αιθιοπες	𐁁𐀴𐀍𐀤
αιθιοψ	𐁁𐀴𐀍𐀤
αιθων	𐁁𐀵
αικοντας	𐁁𐀒𐀲
αιξμα	𐁁𐀏𐀭𐀔
αιξμανς	𐁁𐀏𐀭𐀔
αιχμη	𐁁𐀏𐀭𐀔
αιϝαια	𐁁𐀷𐀊
αιϝατας	𐁁𐀷𐀲
αιϝολος	𐁁𐀺𐀫
ακαρανος	𐀀𐀏𐀨𐀜
ακασιον	𐀀𐀏𐀯𐀍𐀚
ακασιονει	𐀀𐀏𐀯𐀍𐀚
ακβαιμων	𐀀𐀤𐀗
ακορϝος	𐀀𐀒𐀺
ακσοτας	𐀀𐀒𐀰𐀲
ακταιος	𐀀𐀏𐀲𐀍
ακτιστος	𐀀𐀑𐀴𐀵
ακτοινος	𐀀𐀒𐀵𐀜
ακτωρ	𐀀𐀒𐀵
αλακατειαι	𐀀𐀨𐀏𐀳𐀊
αλακατειαιον	𐀀𐀨𐀏𐀳𐀊𐀃
αλειφαζοος	𐀀𐀩𐀞𐀿𐀃
αλειφαρ	𐀀𐀩𐀞
αλειφοβιος	𐀀𐀩𐀞𐀿𐀃
αλεκτρυϝων	𐀀𐀩𐀓𐀶𐀬𐀺
αλεξανδρα	𐀀𐀩𐀏𐀭𐀅𐀨
αλεξευς	𐀀𐀩𐀐𐀮𐀄
αλεξιτοιο	𐀀𐀩𐀑𐀯𐀵𐀍
αλεξιτος	𐀀𐀩𐀑𐀯𐀵𐀍
αλκευς	𐀀𐀐𐀄
αλκμανωρ	𐀀𐀏𐀔𐀜
αλοιφη	𐀀𐀩𐀞
αμαρυταο	𐀀𐀔𐀬𐀲𐀃
αμαρυτας	𐀀𐀔𐀬𐀲𐀃
αμβατος	𐀀𐀣𐀵
αμβοτας	𐀀𐀦𐀲
αμνισιος	𐀀𐀖𐀛𐀯𐀍
αμνισονδε	𐀀𐀖𐀛𐀰𐀆
αμνισος	𐀀𐀖𐀛𐀰𐀆
αμπυκες	𐀀𐀢𐀏
αμπυκοϝοργος	𐀀𐀢𐀒𐀺𐀒
αμπυξ	𐀀𐀢𐀏
αμυνθαϝων	𐀀𐀘𐀲𐀺
αμφι	𐀀𐀠
αμφιαγρος	𐀀𐀠𐀊𐀒𐀫
αμφιαρευς	𐀀𐀠𐀊𐀩𐀺
αμφιαρηϝος	𐀀𐀠𐀊𐀩𐀺
αμφιβατος	𐀀𐀠𐀦𐀵
αμφιγετας	𐀀𐀠𐀋𐀲
αμφιδωρος	𐀀𐀠𐀈𐀫
αμφιεχειν	𐀀𐀠𐀁𐀐
αμφιεχω	𐀀𐀠𐀁𐀐
αμφιλαϝος	𐀀𐀠𐀨𐀺
αμφιλαϝων	𐀀𐀠𐀨𐀺
αμφιμηδης	𐀀𐀠𐀕𐀆
αμφινοεϝιοι	𐀀𐀠𐀜𐀁𐀹𐀍
αμφιπολος	𐀀𐀠𐀡𐀫
αμφιποτας	𐀀𐀠𐀦𐀲
αμφιποτος	𐀀𐀠𐀦𐀵
αμφιφορευς	𐀀𐀠𐀡𐀩𐀸
αμφιφορηϝες	𐀀𐀠𐀡𐀩𐀸
αμφιἁλος	𐀀𐀠𐁀𐀫
αμφονευς	𐀀𐀡𐀚𐀸
αμφονεϝει	𐀀𐀡𐀚𐀸
αμφοτεραι	𐀀𐀡𐀳𐀨
αμφοτερωθεν	𐀀𐀡𐀳𐀫𐀳
αναιτα	𐀀𐀙𐀂𐀲
αναιτον	𐀀𐀙𐀂𐀲
ανακτορα	𐀷𐀙𐀏𐀳𐀨
αναμπυκες	𐀀𐀙𐀢𐀐
αναρμοστα	𐀀𐀙𐀗𐀲
αναρμοστον	𐀀𐀙𐀗𐀲
ανδετηρ	𐀀𐀆𐀳
ανδετηρες	𐀀𐀆𐀳
ανδριαντει	𐀀𐀇𐀪𐀊𐀠
ανδριαφι	𐀀𐀇𐀪𐀊𐀠
ανδριος	𐀀𐀇𐀪𐀊𐀠
ανεμων	𐀀𐀚𐀗𐀂𐀁𐀩𐀊
ανερ	𐀀𐀇𐀪𐀊𐀠
ανετα	𐀀𐀚𐀲
ανευθεν	𐀀𐀚𐀄𐀳
ανευς	𐀀𐀚𐀄𐀳
ανευτει	𐀀𐀚𐀄𐀳
ανθεμων	𐀀𐀳𐀗
ανθρωπος	𐀀𐀵𐀫𐀡
ανθρωπω	𐀀𐀵𐀫𐀡
ανια	𐀀𐀛𐀊
ανιατος	𐀀𐀛𐀊𐀵
ανιαφι	𐀀𐀛𐀊
ανιημι	𐀀𐀚𐀲
ανονον	𐀀𐀜𐀜
αντανωρ	𐀀𐀲𐀜
ανυκος	𐀀𐀝𐀒
ανυτος	𐀀𐀝𐀵
ανωνον	𐀀𐀜𐀜
ανωπος	𐀀𐀜𐀡
ανωϝεις	𐀀𐀜𐀸
ανωϝτος	𐀀𐀜𐀸
αξονες	𐀀𐀒𐀰𐀚
απεασα	𐀀𐀟𐀀𐀭
απεδωκε	𐀀𐀢𐀈𐀐
απεηκε	𐀀𐀟𐀁𐀐
απειμι	𐀀𐀟𐀀𐀭
απελιταϝων	𐀀𐀟𐀪𐀲𐀺
απεοντες	𐀀𐀟𐀀𐀭
αποδιδω	𐀀𐀢𐀈𐀐
αποδοσις	𐀀𐀢𐀈𐀯
απταρϝα	𐀀𐀞𐀲𐀷
απταρϝαια	𐀀𐀞𐀲𐀷𐀊
απταρϝαιος	𐀀𐀞𐀲𐀷𐀊
απτερα	𐀀𐀞𐀲𐀷
απυδοσις	𐀀𐀢𐀈𐀯
απυδωκε	𐀀𐀢𐀈𐀐
αραρμοτημενα	𐀀𐀨𐀫𐀗𐀳𐀕𐀙
αραρμοτημενος	𐀀𐀨𐀫𐀗𐀳𐀕𐀙
αραρυια	𐀀𐀨𐀬𐀊
αραρυοντα	𐀀𐀨𐀬𐀺𐀀
αραρυϝοα	𐀀𐀨𐀬𐀺𐀀
αργειοιο	𐀀𐀐𐀍𐀍
αργειος	𐀀𐀐𐀍𐀍
αργοθευς	𐀀𐀒𐀳𐀄
αργυρος	𐀀𐀓𐀫
αρεια	𐀀𐀩𐀊
αρειμενης	𐀀𐀩𐀕𐀚
αρειονα	𐀀𐁊𐀀
αρειονες	𐀀𐁊𐀁
αρειονος	𐀀𐁊𐀍
αρειος	𐀀𐀩𐀊
αριοα	𐀀𐁊𐀀
αριοες	𐀀𐁊𐀁
αριοιο	𐀀𐁊𐀍
αρμοθηϝια	𐀀𐀗𐀳𐀹𐀊
αρμοιεντοι	𐀀𐀗𐀂𐀋𐀵
αρμον	𐀀𐀗
αρμοσι	𐀀𐀗
αρμοστηρ	𐀀𐀗𐀳𐀩
αρμοστηρες	𐀀𐀗𐀳𐀩
αρμοτα	𐀀𐀗
αρμοτε	𐀀𐀗
αρμοτεων	𐀀𐀗𐀲𐀍
αρμοτεωνανδε	𐀀𐀗𐀲𐀍
αρνεια	𐀺𐀫𐀚𐀊
αρουρα	𐀀𐀬𐀨
αρπαγευς	𐀀𐀞𐀋𐀄
αρτεμις	𐀀𐀴𐀖𐀳
αρτεμιτιος	𐀀𐀳𐀖𐀴𐀍
αρτεμων	𐀀𐀳𐀗
αρτιμιτει	𐀀𐀴𐀖𐀳
αρτοποιος	𐀀𐀵𐀡𐀦
αρτοποπος	𐀀𐀵𐀡𐀦
αρχελαϝος	𐀀𐀐𐀨𐀺
αρχελαϝων	𐀀𐀐𐀨𐀺
αρχη	𐀃𐀏
ασαμινθος	𐀀𐀭𐀖𐀵
ασιατιαι	𐀀𐀯𐀊𐀴𐀊
ασιϝια	𐀀𐀯𐀹𐀊
ασιϝιος	𐀀𐀯𐀹𐀊
ασκετερες	𐀀𐀐𐀳𐀩
ασκητριαι	𐀀𐀐𐀴𐁈𐀃
ασκητριαων	𐀀𐀐𐀴𐁈𐀃
ασπαρτα	𐀀𐀞𐀲
αταλανσιος	𐀀𐀲𐀨𐀯𐀍
ατηϝει	𐀀𐀳𐀸
ατρειϝια	𐀀𐀳𐀩𐀹𐀊
ατυγος	𐀀𐀶𐀒
ατυκος	𐀀𐀶𐀒
αυγευς	𐁂𐀐𐀷
αυγεϝαν	𐁂𐀐𐀷
αυλοι	𐁂𐀫
αυλος	𐁂𐀫
αυτιας	𐁂𐁋
αυτον	𐀵𐀁
αυτου	𐀵𐀍
αφαρευς	𐀀𐀞𐀩𐀄
αφετριαι	𐀀𐀟𐀴𐁈
αφιημι	𐀀𐀟𐀁𐀐
αφυ	𐀀𐁆
αφυγανες	𐀀𐁆𐀏𐀚
αφυνδε	𐀀𐁆
αφυϝει	𐀀𐁆
αχαια	𐀀𐀏𐀹𐀊𐀆
αχαιος	𐀀𐀏𐀺
αχαιϝια	𐀀𐀏𐀹𐀊𐀆
αχαιϝιανδε	𐀀𐀏𐀹𐀊𐀆
αχαιϝος	𐀀𐀏𐀺
αχερων	𐀀𐀐𐀫
αχθων	𐀀𐀒𐀵
αχιλευς	𐀀𐀑𐀩𐀄
αψαγιος	𐀀𐀞𐀭𐀑𐀍
αϝειξευς	𐀀𐀸𐀐𐀮𐀄
βασιλευς	𐀣𐀯𐀩𐀄
βλητριω	𐀤𐀩𐀴𐀪𐀍
βλητρον	𐀤𐀩𐀴𐀪𐀍
βληχων	𐀏𐀨𐀒
βουβοτας	𐀦𐀄𐀦𐀲
βουκαρα	𐀦𐀄𐀏𐀨
βουκολος	𐀦𐀄𐀒𐀫
βουκρανια	𐀦𐀄𐀏𐀨
βους	𐀦𐀃
βρωμυλος	𐀦𐀫𐀘𐀫
γεγινωμενα	𐀤𐀥𐀜𐀕𐀙
γεγινωμενος	𐀤𐀥𐀜𐀕𐀙
γεγινωτος	𐀤𐀥𐀜𐀕𐀙
γερονσια	𐀐𐀫𐀯𐀊
γερουσια	𐀐𐀫𐀯𐀊
γιος	𐀂𐀋𐀸
γλαυκος	𐀏𐀨𐀄𐀒
γλαχων	𐀏𐀨𐀒
γραω	𐀁𐀏𐀨𐀁𐀸
γυναια	𐀓𐀙𐀊
γυναιξι	𐀓𐀙𐀊
δαδαλειον	𐀅𐀅𐀩𐀍𐀆
δαδαλειονδε	𐀅𐀅𐀩𐀍𐀆
δαιαρος	𐀅𐀊𐀫
δαιποντας	𐀅𐀂𐀦𐀲
δαιτραρος	𐀅𐀂𐀲𐀨𐀫
δαματερ	𐀅𐀔𐀳
δαματες	𐀅𐀔𐀳
δαμνιος	𐀅𐀖𐀛𐀍
δαμοκλος	𐀅𐀗𐀒𐀫
δαμος	𐀅𐀗
δαρων	𐀅𐀫
δαταιαρος	𐀅𐀲𐀊𐀫
δαφυρινθοιο	𐀅𐁆𐀪𐀵𐀍
δαϝευφι	𐀅𐀸𐀄𐀠
δαϝια	𐀅𐀹𐀊
δαϝιος	𐀅𐀹𐀊
δαϝος	𐀅𐀸𐀄𐀠
δαϝων	𐀅𐀸𐀄𐀠
δεδεμενος	𐀆𐀆𐀕𐀜
δεδικυια	𐀆𐀇𐀓𐀊
δεδομενα	𐀆𐀈𐀕𐀙
δειπνον	𐀆𐀦𐀜
δεκτυϝοργος	𐀆𐀓𐀶𐀺𐀒
δεμεοντες	𐀆𐀕𐀃𐀳
δεμνια	𐀆𐀖𐀛𐀀
δεμω	𐀆𐀕𐀃𐀳
δεξατο	𐀆𐀏𐀭𐀵
δεπας	𐀇𐀞
δεσμοις	𐀆𐀰𐀗
δεσμος	𐀆𐀰𐀗
δευκαλιων	𐀆𐀄𐀏𐀪𐀍
δευκιοιο	𐀆𐀄𐀑𐀍𐀍
δευκιος	𐀆𐀄𐀑𐀍𐀍
δεχομαι	𐀆𐀏𐀭𐀵
δημος	𐀅𐀗
διας	𐀇𐀸
διδασκαλει	𐀇𐀅𐀏𐀩
διδασκαλος	𐀇𐀅𐀏𐀩
διδασκω	𐀆𐀇𐀓𐀊
διδονσι	𐀈𐀮
διδω	𐀆𐀈𐀕𐀙
διδω	𐀈𐀮
διδωμι	𐀆𐀈𐀕𐀙
διημερον	𐀇𐀹𐀊𐀕𐀫
δικοναρεια	𐀇𐀒𐀙𐀩𐀊
δικοναρος	𐀇𐀒𐀙𐀫
δικτα	𐀇𐀏𐀲𐀆
δικταιος	𐀇𐀏𐀲𐀍
δικτανδε	𐀇𐀏𐀲𐀆
δικτη	𐀇𐀏𐀲𐀆
δινωτος	𐀤𐀥𐀜𐀕𐀙
διονυσος	𐀇𐀺𐀛𐀰𐀍
διοςιεϝει	𐀇𐀺𐀂𐀋𐀸
διπας	𐀇𐀞
διπτερα	𐀇𐁇𐀨
διπτεραφορος	𐀇𐁇𐀨𐀡𐀫
διρος	𐀇𐀫
διυαιον	𐀇𐀄𐀊𐀍
διυαϝων	𐀇𐀄𐀊𐀺
διυια	𐀇𐀄𐀊
διυος	𐀇𐀄𐀍
διψια	𐀇𐀠𐀯𐀊
διψιεϝιος	𐀇𐀠𐀮𐀹𐀍
διψιος	𐀇𐀠𐀯𐀊
διψος	𐀇𐀠𐀰𐀂
διψωι	𐀇𐀠𐀰𐀂
διϝει	𐀇𐀸
διϝια	𐀇𐀄𐀊
διϝιαιονδε	𐀇𐀄𐀊𐀍
διϝιαται	𐀇𐀹𐀊𐀲
διϝιευς	𐀇𐀹𐀋𐀄
διϝιον	𐀇𐀹𐀍
διϝιος	𐀇𐀄𐀍
διϝονυσοιο	𐀇𐀺𐀛𐀰𐀍
διϝονυσος	𐀇𐀺𐀛𐀰𐀍
διϝος	𐀇𐀸
διϝων	𐀇𐀺
δλευκος	𐀆𐀩𐀄𐀒
δοελα	𐀈𐀁𐀨
δοελοι	𐀈𐀁𐀫𐀂
δοελος	𐀈𐀁𐀫
δονδε	𐀈𐀆
δορπεια	𐀈𐀤𐀊
δορπευς	𐀈𐀤𐀊
δορϝειος	𐀈𐀸𐀍
δοσμοι	𐀈𐀰𐀗
δοσμος	𐀈𐀰𐀗
δοσποτα	𐀈𐀡𐀲
δουλη	𐀈𐀁𐀨
δουλοι	𐀈𐀁𐀫𐀂
δουλος	𐀈𐀁𐀫
δριμιος	𐀇𐀪𐀖𐀍
δρομευς	𐀈𐀫𐀕𐀄
δρυτομος	𐀉𐀬𐀵𐀗
δυμας	𐀉𐀔
δυματες	𐀅𐀔𐀳
δυματες	𐀉𐀔
δυνιοιο	𐀉𐀛𐀍
δυνιος	𐀉𐀛𐀍
δυο	𐀉𐀺𐀄𐀠
δυο	𐁄
δυρευς	𐀉𐀩𐀄
δυτασος	𐀉𐀲𐀰
δυϝο	𐁄
δυϝοιοιο	𐀉𐀺𐀍𐀍
δυϝοιος	𐀉𐀺𐀍𐀍
δυϝουπι	𐀉𐀺𐀄𐀠
δυϝωϝεις	𐀉𐀺𐀸
δω	𐀈𐀆
δωρα	𐀈𐀨
δωριευς	𐀈𐀪𐀋𐀸
δωριεϝει	𐀈𐀪𐀋𐀸
δωριεϝες	𐀈𐀪𐀋𐀸
δωσει	𐀈𐀮
δωσονσι	𐀈𐀮
δϝιαμερον	𐀇𐀹𐀊𐀕𐀫
δϝο	𐁄
εγγραεϝεις	𐀁𐀏𐀨𐀁𐀸
εγκειμαι	𐀁𐀐𐀍𐀵
εγκειοντοι	𐀁𐀐𐀍𐀵
εγμα	𐀁𐀏𐀔𐀠
εγματει	𐀁𐀏𐀔𐀠
εγμαφι	𐀁𐀏𐀔𐀠
εγχενσι	𐀁𐀒
εγχεροπονοι	𐀁𐀐𐀫𐀦𐀜
εγχερος	𐀁𐀐𐀫
εγχεω	𐀁𐀓𐀮𐀸𐀤
εγχος	𐀁𐀒
εγχυσηϝες	𐀁𐀓𐀮𐀸𐀤
εδαευς	𐀁𐀅𐀁𐀄
εενσι	𐀁𐀁𐀯
εζωϝος	𐀁𐀿𐀺
εθιζω	𐀀𐀁𐀴𐀵
ειδομενευς	𐀁𐀈𐀕𐀚𐀄
ειμι	𐀁𐀁𐀯
ειμι	𐀁𐀃
εκτωρ	𐀁𐀒𐀵
ελαιον	𐀁𐀨𐀺
ελαιϝον	𐀁𐀨𐀺
ελατει	𐀁𐀨𐀳𐀂
ελατειος	𐀁𐀨𐀳𐀂𐀍
ελατονδε	𐀁𐀨𐀳𐀂
ελατος	𐀁𐀨𐀳𐀂
ελαφων	𐀁𐀨𐀡𐀪𐀕𐀚
ελεει	𐀁𐀩𐀁
ελευθερα	𐀁𐀩𐀄𐀳𐀨
ελευθεραι	𐀁𐀩𐀄𐀳𐀩
ελευθερει	𐀁𐀩𐀄𐀳𐀩
ελευθερος	𐀁𐀩𐀄𐀳𐀨
ελευθερω	𐀁𐀩𐀄𐀳𐀫𐀮
ελευθερωσεεν	𐀁𐀩𐀄𐀳𐀫𐀮
ελευθια	𐀁𐀩𐀄𐀴𐀊
ελεφαντει	𐀁𐀩𐀞
ελεφαντειαφι	𐀁𐀩𐀞
ελεφαντειος	𐀁𐀩𐀞
ελεφαντος	𐀁𐀩𐀞
ελεφας	𐀁𐀩𐀞
ελικα	𐀁𐀪𐀏
ελικας	𐀁𐀪𐀏
ελικη	𐀁𐀪𐀏
ελλοφαγεια	𐀁𐀫𐀞𐀐𐀊
ελλοφαγετας	𐀁𐀫𐀞𐀐𐀲
ελλοφαγευς	𐀁𐀫𐀞𐀐𐀲
ελομανθος	𐀁𐀫𐀔𐀵
ελος	𐀁𐀩𐀁
ελυμνιαι	𐀁𐀬𐀖𐀛𐀊
εμβαρος	𐀁𐀣𐀫
εμει	𐀁𐀕
εμμισθος	𐀁𐀖𐀵
εμμισθων	𐀁𐀖𐀵
εναπλους	𐀁𐀙𐀡𐀫
ενεενσι	𐀁𐀁𐀯
ενειμι	𐀁𐀁𐀯
ενεκα	𐀁𐀚𐀏
ενεσιδαονει	𐀁𐀚𐀯𐀅𐀃𐀚
ενεσιδαων	𐀁𐀚𐀯𐀅𐀃𐀚
ενθεν	𐀁𐀳
ενι	𐀁𐀕
ενιπατευς	𐀁𐀛𐀞𐀳𐀸
ενιπατευϝει	𐀁𐀛𐀞𐀳𐀸
εννεϝοπεζα	𐀁𐀚𐀺𐀟𐀼
εντοιχια	𐀁𐀵𐀑𐀊
εντοσϝοργοι	𐀁𐀵𐀺𐀒
εντροπαται	𐀁𐀵𐀫𐀣𐀲
ενυϝαλιος	𐀁𐀝𐀷𐀪𐀍
εξων	𐀁𐀒𐀰
εξωνος	𐀁𐀒𐀰
εξωϝοργοι	𐀁𐀒𐀰𐀺𐀒
επεσια	𐀁𐀤𐀯𐀍
επεσιος	𐀁𐀤𐀯𐀍
επετας	𐀁𐀤𐀲
επι	𐀁𐀠
επι	𐀃𐀠
επιδιδαστοι	𐀁𐀠𐀇𐀅𐀵
επιδιδωμι	𐀁𐀠𐀇𐀅𐀵
επιζωστα	𐀁𐀠𐀿𐀲
επικορϝοι	𐀁𐀠𐀒𐀺
επιχιτωνια	𐀁𐀠𐀑𐀵𐀛𐀊
επιϝεστριος	𐀁𐀠𐀸𐀴𐀪𐀍
ερα	𐀁𐀨
εραθρα	𐀁𐀨𐀲𐀨
εραθρεϝα	𐀁𐀨𐀳𐀩𐀸
εραθρεϝει	𐀁𐀨𐀳𐀩𐀸
εραια	𐀁𐀨𐀊
εργινος	𐀁𐀑𐀜
ερεεν	𐀁𐀩𐀁
ερεμος	𐀁𐀩𐀗
ερεται	𐀁𐀩𐀲
ερετας	𐀁𐀩𐀲
ερεταων	𐀁𐀩𐀲
ερεττειν	𐀁𐀩𐀁
ερευς	𐀁𐀩𐀁𐀄
ερημον	𐀁𐀩𐀗
εριθα	𐀁𐀪𐀲
ερικλευς	𐀁𐀪𐀐𐀩𐀸
ερικλεϝεις	𐀁𐀪𐀐𐀩𐀸
ερικορϝος	𐀁𐀪𐀒𐀺
ερινυς	𐀁𐀪𐀝
ερμαἁι	𐀁𐀔𐁀
ερμαἁς	𐀁𐀔𐁀
ερμης	𐀁𐀔𐁀
ερραμμενη	𐀁𐀨𐀟𐀕𐀙
ερραπμενα	𐀁𐀨𐀟𐀕𐀙
ερυθρα	𐀁𐀬𐀲𐀨
ερυθρας	𐀁𐀬𐀲𐀨
ερυθρος	𐀁𐀬𐀵𐀫
ερυμανθος	𐀁𐀫𐀔𐀵
ερχομεναταο	𐀁𐀒𐀕𐀙𐀲𐀃
ερχομενατας	𐀁𐀒𐀕𐀙𐀲𐀃
ερχομενος	𐀁𐀒𐀕𐀜
εσαλευς	𐀁𐀭𐀩𐀄
εσαλεϝια	𐀁𐀭𐀩𐀹𐀊
εσαλος	𐀁𐀭𐀩𐀄
εσχαρα	𐀁𐀏𐀨
εταγευς	𐀁𐀲𐀋𐀄
εταϝονευς	𐀁𐀲𐀺𐀚𐀄
ετεοκλιος	𐀁𐀳𐀺𐀐𐀩𐀸𐀂𐀍
ετερος	𐁀𐀳𐀫
ετεϝας	𐀁𐀳𐀷
ετεϝοκλεϝειος	𐀁𐀳𐀺𐀐𐀩𐀸𐀂𐀍
ετωνιον	𐀁𐀵𐀛𐀍
ευαγρος	𐀁𐀄𐀷𐀒𐀫
ευδαμος	𐀁𐀄𐀅𐀗
ευδειϝελος	𐀁𐀄𐀆𐀸𐀫
ευδονος	𐀁𐀄𐀈𐀜
ευθαλεϝοςϝορϝος	𐀁𐀄𐀲𐀩𐀺𐀺𐀺
ευμεδης	𐀁𐀄𐀕𐀆
ευμενης	𐀁𐀄𐀕𐀚
ευμετας	𐀁𐀄𐀕𐀲
ευναϝος	𐀁𐀄𐀙𐀺
ευορμος	𐀁𐀄𐀃𐀗
ευπλοϝος	𐀁𐀄𐀡𐀫𐀺
ευριπος	𐀁𐀹𐀪𐀡
ευρυδαμος	𐀁𐀄𐀬𐀅𐀗
ευρυποτας	𐀁𐀄𐀬𐀦𐀲
ευρυπτολεμοιο	𐀁𐀄𐀬𐀡𐀵𐀩𐀗𐀍
ευρυπτολεμος	𐀁𐀄𐀬𐀡𐀵𐀩𐀗𐀍
ευτροσσεσθαι	𐀁𐀸𐀟𐀮𐀰𐀕𐀙
ευχετοι	𐀁𐀄𐀐𐀵
ευχομαι	𐀁𐀄𐀐𐀵
ευχομενος	𐀁𐀄𐀒𐀕𐀜
εφιαλτας	𐀁𐀠𐀊𐀲
εχεδαμος	𐀁𐀐𐀅𐀗
εχεδαμων	𐀁𐀐𐀅𐀗
εχεεν	𐀁𐀐
εχει	𐀁𐀐
εχειν	𐀁𐀐
εχελιαϝων	𐀁𐀐𐁈𐀺
εχεμηδης	𐀁𐀐𐀕𐀆
εχινος	𐀁𐀑𐀜
εχονσι	𐀁𐀐
εχοντες	𐀁𐀒
εχουσι	𐀁𐀐
εχων	𐀁𐀒
εων	𐀁𐀃
εϝεψεσομενα	𐀁𐀸𐀟𐀮𐀰𐀕𐀙
εϝιταιος	𐀁𐀹𐀲𐀍
εϝιτευς	𐀁𐀹𐀳𐀄
εϝιτεϝει	𐀁𐀹𐀳𐀄
εϝιτεϝιος	𐀁𐀹𐀲𐀍
εϝριπια	𐀁𐀹𐀪𐀠𐀊
εϝριπως	𐀁𐀹𐀪𐀡
ζαεθροι	𐀼𐀁𐀵𐀫
ζακυνθιος	𐀼𐀓𐀯𐀍
ζακυνσιος	𐀼𐀓𐀯𐀍
ζαμαεϝιαι	𐀼𐀔𐀁𐀹𐀀
ζαϝετες	𐀼𐀸𐀳
ζειακρανα	𐀽𐀂𐀊𐀏𐀨𐀙
ζεσομενος	𐀽𐀰𐀕𐀜
ζευγεσι	𐀽𐀄𐀐𐀯
ζευγος	𐀽𐀄𐀐𐀯
ζευς	𐀇𐀸
ζεφυραι	𐀽𐁆𐀨
ζεφυρεαι	𐀽𐁆𐁉
ζεφυρος	𐀽𐁆𐀨
ζωϝιος	𐀿𐀹𐀍
ηνια	𐀀𐀛𐀊
θαλαματας	𐀲𐀨𐀔𐀲
θαλαμικα	𐀲𐀨𐀖𐀏
θαλαμισκα	𐀲𐀨𐀖𐀏
θαρσυς	𐀲𐀱
θεμιστια	𐀳𐀖𐀴𐀊
θεμιστωναγος	𐀴𐀖𐀵𐀀𐀐𐀁
θεμιτοςαγος	𐀴𐀖𐀵𐀀𐀐𐀁
θεοδωρα	𐀳𐀃𐀈𐀨
θεοιο	𐀳𐀃
θεοις	𐀳𐀃
θεον	𐀳𐀃
θεος	𐀳𐀃
θεοφορια	𐀳𐀃𐀡𐀪𐀊
θετω	𐀳𐀐
θηβαι	𐀳𐀣𐀆
θηβανδε	𐀳𐀣𐀆
θηκβαια	𐀳𐀣𐀊
θηκε	𐀳𐀐
θηρασια	𐀤𐀨𐀯𐀊
θηρατευς	𐀶𐀨𐀳𐀄
θησευς	𐀳𐀮𐀄
θορνοελκητηριον	𐀵𐀜𐀁𐀐𐀳𐀪𐀍
θορνος	𐀵𐀜
θορνοϝοργος	𐀵𐀫𐀜𐀺𐀒
θρανυς	𐀲𐀨𐀝
θρανυϝες	𐀲𐀨𐀝
θρονος	𐀵𐀜
θυγατερ	𐀶𐀏𐀳
θυγατερες	𐀶𐀏𐀳
θυϝεα	𐀶𐀸𐀀
θυϝεστας	𐀶𐀸𐀲
θυϝος	𐀶𐀸𐀀
θωρακες	𐀵𐀨𐀏
θωραξ	𐀵𐀨𐀏
θωριος	𐀵𐀪𐀍
ιατερ	𐀂𐀊𐀳
ιατηρ	𐀂𐀊𐀳
ιαϝονει	𐀂𐀊𐀺𐀚
ιαϝων	𐀂𐀊𐀺𐀚
ιδομενεια	𐀂𐀈𐀕𐀚𐀊
ιδομενειος	𐀂𐀈𐀕𐀚𐀊
ιεντοι	𐀂𐀋𐀵
ιερεια	𐀀𐀚𐀗𐀂𐀁𐀩𐀊
ιερεια	𐀂𐀋𐀩𐀊
ιερευς	𐀂𐀋𐀩𐀄
ιερεϝιος	𐀂𐀋𐀩𐀹𐀍
ιερεϝος	𐀂𐀋𐀩𐀄
ιερος	𐀂𐀋𐀫
ιερουργος	𐀂𐀋𐀫𐀺𐀒
ιεροϝοργος	𐀂𐀋𐀫𐀺𐀒
ιετο	𐀂𐀋𐀵
ιεϝει	𐀂𐀋𐀸
ιημι	𐀂𐀋𐀵
ιημι	𐀂𐀍𐀳
ιθειαι	𐀂𐀳𐀊𐀃
ιθειαων	𐀂𐀳𐀊𐀃
ιθευς	𐀂𐀳𐀊𐀃
ιθυνω	𐀂𐀳𐀊𐀃
ικετας	𐀂𐀐𐀄
ικετης	𐀂𐀐𐀄
ικευς	𐀂𐀐𐀄
ινια	𐀂𐀛𐀊
ιοντες	𐀂𐀍𐀳
ιος	𐀂𐀋𐀸
ιπνος	𐀂𐀡𐀜
ιππια	𐀂𐀥𐀊
ιππιω	𐀂𐀥𐀊
ιππος	𐀂𐀦
ισυχυϝδοτος	𐀂𐀱𐀓𐀺𐀈𐀵
ιφεμεδεια	𐀂𐀟𐀕𐀆𐀊
ιφεμεδειαιον	𐀂𐀟𐀕𐀆𐀊𐀍
ιφιμηδεια	𐀂𐀟𐀕𐀆𐀊
ιψεϝας	𐀂𐀟𐀮𐀷
ιϝαξ	𐀂𐀷𐀏
ιϝασος	𐀂𐀷𐀰
καδασος	𐀣𐀅𐀰
καεσαμενος	𐀏𐀁𐀭𐀕𐀜
καεσευς	𐀏𐀁𐀮𐀄
καζοες	𐀏𐀿𐀁
κακyοες	𐀏𐀿𐀁
κακιονες	𐀏𐀿𐀁
καμα	𐀏𐀔
καμαευς	𐀏𐀔𐀁𐀄
κανθυληϝιαι	𐀏𐀶𐀩𐀹𐀊
καπνια	𐀏𐀠𐀛𐀊
καρααφι	𐀏𐀨𐀀𐀠
καρδαμια	𐀏𐀅𐀖𐀊
καρδαμον	𐀏𐀅𐀖𐀊
καρνυϝασος	𐀣𐀝𐀷𐀰
καρπαθια	𐀏𐀞𐀯𐀊
καρπαθος	𐀏𐀨𐀞𐀰
καρπασια	𐀏𐀞𐀯𐀊
καρπασος	𐀏𐀨𐀞𐀰
καρπος	𐀏𐀡
καρτις	𐀏𐀴
καρυα	𐀏𐀬𐀠
καρυκες	𐀏𐀬𐀐
καρυξ	𐀏𐀬𐀐
καρυστος	𐀏𐀬𐀵
καρυφι	𐀏𐀬𐀠
καρυϝει	𐀏𐀬𐀠
καστωρ	𐀏𐀵
καταϝας	𐀏𐀲𐀷
κειακρανα	𐀐𐀁
κειει	𐀐𐀁
κειος	𐀐𐀂𐀍
κεκαυμενος	𐀐𐀏𐀄𐀕𐀜
κεκειμενα	𐀐𐀐𐀕𐀙
κεκειμενος	𐀐𐀐𐀕𐀙
κελαινος	𐀐𐀨𐀜
κελχιδες	𐀐𐀑𐀆
κελχις	𐀐𐀑
κεουσας	𐀐𐀄𐀭
κεραευς	𐀐𐀨𐀁𐀸
κεραεϝεις	𐀐𐀨𐀁𐀸
κεραμεια	𐀐𐀨𐀕𐀊
κεραμευς	𐀐𐀨𐀕𐀄
κερανα	𐀤𐀨𐀙
κερας	𐀐𐀨
κερασια	𐀤𐀨𐀯𐀊
κερασω	𐀐𐀨𐀰
κερατιοιοϝορϝος	𐀐𐀨𐀴𐀍𐀍𐀺𐀺
κεραυιος	𐀐𐀨𐀄𐀍
κεραἁ	𐀐𐀨
κερκιος	𐀐𐀑𐀍
κερκυραιοι	𐀒𐀫𐀓𐀨𐀂𐀍
κερνα	𐀤𐀨𐀙
κεροϝος	𐀐𐀫𐀺
κεσανδρος	𐀐𐀭𐀈𐀫
κεταϝος	𐀤𐀲𐀺
κετραγευς	𐀤𐀲𐀨𐀋𐀄
κηρυξ	𐀏𐀬𐀐
κηϝετοιο	𐀐𐀸𐀵𐀍
κηϝετος	𐀐𐀸𐀵𐀍
κιρτανος	𐀑𐀲𐀜
κιϝων	𐀑𐀺
κλαδϝιφορος	𐀏𐀨𐀹𐀡𐀫
κλαρευς	𐀏𐀨𐀩𐀸
κλαρεϝεις	𐀏𐀨𐀩𐀸
κλαρεϝες	𐀏𐀨𐀩𐀸
κλασμα	𐀏𐀨𐀔𐀵
κλασματος	𐀏𐀨𐀔𐀵
κλειδοφορος	𐀏𐀨𐀹𐀡𐀫
κλυμενος	𐀓𐀬𐀕𐀜
κνακος	𐀏𐀙𐀒
κναπευς	𐀏𐀙𐀟𐀄
κναπτω	𐀏𐀙𐀟𐀄
κνηκος	𐀏𐀙𐀒
κνιδιαι	𐀑𐀛𐀇𐀊
κνωσια	𐀒𐀜𐀯𐀊
κνωσιος	𐀒𐀜𐀯𐀊
κνωσονδε	𐀒𐀜𐀰
κνωσος	𐀒𐀜𐀰
κογχυλος	𐀒𐀓𐀫
κογχυς	𐀒𐀓
κοδοιο	𐀒𐀈𐀍
κοδος	𐀒𐀈𐀍
κολιαδνα	𐀒𐀪𐁀𐀅𐀙
κολιαδνος	𐀒𐀪𐁀𐀅𐀙
κολιαντρος	𐀒𐀪𐁀𐀅𐀙
κολχιδας	𐀒𐀑𐀅
κολχιος	𐀒𐀑𐀍
κομαϝεις	𐀒𐀔𐀸
κομαϝεντα	𐀒𐀔𐀸𐀲
κομαϝεντει	𐀒𐀔𐀸
κομαϝεντεια	𐀒𐀔𐀸𐀳𐀊
κομαϝεντος	𐀒𐀔𐀸
κορετερ	𐀒𐀩𐀳
κορετηρες	𐀒𐀩𐀳
κορετηριον	𐀒𐀩𐀳𐀪𐀍
κορη	𐀒𐀷
κορινθια	𐀒𐀪𐀯𐀊
κορινθιος	𐀒𐀪𐀯𐀊
κορινθος	𐀒𐀪𐀵
κορινσια	𐀒𐀪𐀯𐀊
κορινσιος	𐀒𐀪𐀯𐀊
κορυθφι	𐀒𐀬
κορυς	𐀒𐀬
κορυϝεια	𐀒𐀬𐀸𐀊
κορωνη	𐀒𐀫𐀜𐀸𐀭
κορωνος	𐀒𐀫𐀜𐀸𐀭
κορωνοϝεσσα	𐀒𐀫𐀜𐀸𐀭
κορϝα	𐀒𐀷
κορϝεια	𐀒𐀸𐀊
κορϝια	𐀦𐀹𐀊
κορϝος	𐀒𐀺
κοτυριονει	𐀒𐀶𐁊
κοτυριων	𐀒𐀶𐁊
κοτυϝει	𐀒𐀶𐀸
κοτυϝος	𐀒𐀶𐀸
κουρη	𐀒𐀷
κουρηια	𐀒𐀬𐀸𐀊
κουρηια	𐀦𐀹𐀊
κουρητες	𐀓𐀩𐀸
κουρηϝες	𐀓𐀩𐀸
κουρια	𐀒𐀸𐀊
κουρος	𐀒𐀺
κοφινα	𐀒𐀠𐀙
κοφινος	𐀒𐀠𐀙
κοϝος	𐀒𐀺
κρηθευς	𐀐𐀩𐀳𐀄
κρηθιϝος	𐀐𐀩𐀴𐀺
κρησιοϝεργης	𐀐𐀩𐀯𐀍𐀸𐀐
κριθα	𐀑𐀪𐀲
κριθη	𐀑𐀪𐀲
κριτανος	𐀑𐀲𐀜
κροιοϝορϝια	𐀒𐀫𐀍𐀺𐀹𐀊
κροκυλαιοι	𐀒𐀫𐀓𐀨𐀂𐀍
κτιενσι	𐀑𐀴𐀋𐀯
κτιμενα	𐀑𐀴𐀕𐀙
κτιμενος	𐀑𐀴𐀕𐀙
κτιτας	𐀑𐀴𐀲
κτοινα	𐀒𐀵𐀂𐀙
κτοιναων	𐀒𐀵𐀂𐀙
κτοινοοχοι	𐀒𐀵𐀜𐀃𐀒
κτυγιανωρ	𐀓𐀶𐀣𐀜
κυανος	𐀓𐀷𐀜
κυδωνια	𐀓𐀈𐀛𐀊
κυθεραιος	𐀓𐀳𐀨𐀃
κυθερεαι	𐀓𐀳𐀨𐀃
κυθερευφι	𐀓𐀳𐀩𐀄𐀠
κυθηρα	𐀓𐀳𐀩𐀄𐀠
κυκαδαρος	𐀓𐀏𐀅𐀫
κυκαλος	𐀒𐀏𐀫
κυκλευς	𐀓𐀐𐀩𐀄
κυλανος	𐀓𐀨𐀜
κυμινον	𐀓𐀖𐀜
κυναγετας	𐀓𐀙𐀐𐀲
κυπαιρος	𐀓𐀞𐀫
κυπαιροϝεν	𐀓𐀞𐀫𐀸
κυπαρισιοι	𐀓𐀞𐀪𐀯𐀍
κυπαρισιος	𐀓𐀞𐀪𐀯𐀍
κυπαρισσος	𐀓𐀞𐀪𐀰
κυπριος	𐀓𐀠𐀪𐀍
κυταισιος	𐀓𐀲𐀴𐀍
κυταιστος	𐀓𐀲𐀂𐀵
κυτεσειοις	𐀓𐀳𐀮𐀍
κυτεσειος	𐀓𐀳𐀮𐀍
κυτισος	𐀓𐀳𐀮𐀍
κυψελος	𐀓𐀟𐀮𐀫
κυϝανος	𐀓𐀷𐀜
κυϝανοϝοργος	𐀓𐀷𐀜𐀺𐀒
κωας	𐀒𐀺
κωκαλος	𐀒𐀏𐀫
κϝαλαθρον	𐀣𐀨𐀵𐀫
κϝαρα	𐀣𐀨
κϝαραισος	𐀣𐀨𐀂𐀰
κϝασιλευς	𐀣𐀯𐀩𐀄
κϝασιλεϝια	𐀣𐀯𐀩𐀹𐀊
κϝοος	𐀦𐀃
λαας	𐀨𐀁𐀊
λαβυρινθος	𐀅𐁆𐀪𐀵𐀍
λαεια	𐀨𐀁𐀊
λακεδαιμονιος	𐀨𐀐𐀅𐀖𐀛𐀍
λακεδαμνιος	𐀨𐀐𐀅𐀖𐀛𐀍
λαμνιαι	𐀨𐀖𐀛𐀊
λαμψακος	𐀨𐀞𐀭𐀒
λαος	𐀨𐀺
λαπανδος	𐀨𐀞𐀵𐀕𐀜
λαπατος	𐀨𐀞𐀵𐀕𐀜
λασυνθιος	𐀨𐀱𐀴𐀍
λασυνθος	𐀨𐀱𐀵
λατιος	𐀨𐀴𐀍
λατω	𐀨𐀵
λαχευς	𐀨𐀐𐀄
λαχυρος	𐀨𐀓𐀫
λαϝαγεια	𐀨𐀷𐀐𐀊
λαϝαγεσια	𐀨𐀷𐀐𐀊
λαϝαγεσιαιον	𐀨𐀷𐀐𐀯𐀊𐀍
λαϝαγεσιος	𐀨𐀷𐀐𐀊
λαϝαγετας	𐀨𐀷𐀐𐀲
λαϝοδοκος	𐀨𐀺𐀈𐀒
λαϝοπονος	𐀨𐀺𐀡𐀜
λαϝος	𐀨𐀺
λαϝρανθαι	𐀨𐀷𐀨𐀲
λεβης	𐀩𐀺
λεβηταριον	𐀩𐀺
λεπευριος	𐀩𐀟𐀄𐀪𐀍
λεπτον	𐀩𐀡𐀵
λευκασος	𐀩𐀄𐀏𐀰
λευκονυχα	𐀩𐀄𐀒𐀝𐀏
λευκοροοφρυς	𐀩𐀄𐀒𐀃𐁆𐀬
λευκος	𐀩𐀄𐀒
λευκτροι	𐀩𐀄𐀒𐀵𐀫
λευκτρον	𐀩𐀄𐀒𐀵𐀫
λεχεστρωτηριον	𐀩𐀐𐀁𐀵𐀫𐀳𐀪𐀍
λεϝοντιοις	𐀩𐀺
λεϝοντφι	𐀩𐀺
λεϝος	𐀩𐀺
λεϝοτερειον	𐀩𐀺
λεϝοτροκορϝοι	𐀩𐀺𐀵𐀫𐀒𐀺
λεϝων	𐀩𐀺
λημνιαι	𐀨𐀖𐀛𐀊
λιμενει	𐀪𐀕𐀚
λιμενες	𐀁𐀨𐀡𐀪𐀕𐀚
λιμην	𐀪𐀕𐀚
λιναγρος	𐀪𐀙𐀒𐀫
λινειαι	𐀪𐀚𐀊
λινον	𐀪𐀜
λουσιεϝειαι	𐀫𐀄𐀯𐀋𐀹𐀊
λουσιος	𐀫𐀄𐀯𐀍
λουσος	𐀫𐀄𐀰
λυκινθιος	𐀬𐀑𐀴𐀍
λυκινθος	𐀬𐀑𐀵
λυκουρος	𐀬𐀒𐀫
λυκοϝορος	𐀬𐀒𐀺𐀫
λυρατας	𐀬𐀨𐀲𐀁
λωχος	𐀫𐀒
μαγα	𐀔𐀏
μαλαθηϝες	𐀔𐀨𐀳𐀸
μαλανενιοι	𐀔𐀨𐀚𐀛𐀍
μαλατευς	𐀔𐀨𐀳𐀄
μαλευρον	𐀕𐀩𐀄𐀫
μαλευς	𐀔𐀩𐀄
μαλθευς	𐀔𐀨𐀳𐀄
μαλθιϝιος	𐀔𐀨𐀳𐀸
μαλιτας	𐀔𐀪𐀲
μαλος	𐀔𐀫𐀠
μαλοφι	𐀔𐀫𐀠
μανασσα	𐀔𐀙𐀭
μανιχος	𐀔𐀛𐀒
μανουρος	𐀔𐀜𐀄𐀫
μαραθος	𐀔𐀨𐀶𐀺
μαραθυϝον	𐀔𐀨𐀶𐀺
μαρινευς	𐀔𐀪𐀚𐀄
μαρινεϝειαι	𐀔𐀪𐀚𐀸𐀊𐀂
ματερ	𐀔𐀳
ματεργαια	𐀔𐀏
ματερθεια	𐀔𐀳𐀩𐀳𐀂𐀊
ματροπυλος	𐀔𐀵𐀫𐀢𐀫
μαυτιος	𐀔𐀄𐀴𐀍
μαχαϝων	𐀔𐀏𐀺
μεδειος	𐀕𐀆𐀂𐀍
μεζοες	𐀕𐀿𐀁
μεζος	𐀕𐀿
μεζοἁ	𐀕𐀿𐁀
μεζων	𐀕𐀿
μειζονα	𐀕𐀿𐁀
μειζονες	𐀕𐀿𐀁
μειζων	𐀕𐀿
μειονα	𐀕𐀄𐀍𐁀
μειονες	𐀕𐀹𐀍𐀁
μειων	𐀕𐀹𐀍
μελεστριαι	𐀕𐀩𐀴𐁈
μελευρον	𐀕𐀩𐀄𐀫
μελιδαματες	𐀕𐀪𐀅𐀔𐀳
μελιδυματες	𐀕𐀪𐀅𐀔𐀳
μελιν	𐀕𐀪
μελιτευς	𐀕𐀪𐀳𐀺
μελιτεϝος	𐀕𐀪𐀳𐀺
μελιτον	𐀕𐀪
μεντα	𐀖𐀲
μετα	𐀕𐀲
μετακεκυμενα	𐀕𐀲𐀐𐀓𐀕𐀙
μετακτιτας	𐀕𐀲𐀑𐀴𐀲
μεταπα	𐀕𐀲𐀞
μεταπανδε	𐀕𐀲𐀞
μεταπιος	𐀕𐀲𐀠𐀍
μετωπευς	𐀕𐀵𐀤𐀄
μεϝιοες	𐀕𐀹𐀍𐀁
μεϝιος	𐀕𐀹𐀍
μεϝιοἁ	𐀕𐀄𐀍𐁀
μεϝιων	𐀕𐀹𐀍
μην	𐀕𐀜
μηνας	𐀕𐀜
μηνιος	𐀕𐀛𐀍
μηνοεια	𐀕𐀜𐀁𐀊
μηνος	𐀕𐀜
μιλατιαι	𐀖𐀨𐀴𐀊
μιλτοϝεσσα	𐀖𐀵𐀸𐀭
μινθα	𐀖𐀲
μνασιϝεργος	𐀔𐀙𐀯𐀸𐀒
μολευς	𐀗𐀩𐀄
μολυβδος	𐀗𐀪𐀺𐀈
μοροπας	𐀗𐀫𐀣
μοροπλος	𐀗𐀫𐀡𐀫
μοψος	𐀗𐀦𐀰
ναισεϝιος	𐀙𐀂𐀮𐀹𐀍
ναος	𐀙𐀹𐀍
ναυδομος	𐀙𐀄𐀈𐀗
ναυσικλεϝεις	𐀙𐀄𐀯𐀐𐀩𐀸
ναυσικλης	𐀙𐀄𐀯𐀐𐀩𐀸
ναϝιλος	𐀙𐀹𐀫
ναϝιος	𐀙𐀹𐀍
ναϝος	𐀙𐀹𐀍
νεα	𐀚𐀷
νεδεϝειει	𐀚𐀆𐀸𐀁
νεδϝα	𐀚𐀆𐀸𐀁
νεδϝατας	𐀚𐀆𐀷𐀲
νεδϝοθεν	𐀚𐀆𐀸𐀁
νεδϝοτανδε	𐀚𐀆𐀸𐀁
νεδϝων	𐀚𐀆𐀸𐀁
νεος	𐀚𐀷
νεστιανωρ	𐀚𐀴𐀊𐀜𐀩
νεϝα	𐀚𐀷
νεϝος	𐀚𐀷
νυμϝαια	𐀝𐀷𐀊
νωφελεα	𐀜𐀟𐀩𐁀
ξανθος	𐀏𐀭𐀵
ξενια	𐀐𐀮𐀚𐀹𐀊
ξενιος	𐀐𐀮𐀚𐀹𐀊
ξενϝια	𐀐𐀮𐀚𐀹𐀊
ξενϝιος	𐀐𐀮𐀚𐀹𐀊
ξιφεε	𐀥𐀯𐀟𐀁
ξιφη	𐀥𐀯𐀟𐀁
ξιϝιαι	𐀑𐀯𐀹𐀊
ξουθος	𐀒𐀰𐀄𐀵
ξυμπαν	𐀓𐀱𐀞
ξυν	𐀓𐀱
ξυνστροφα	𐀓𐀱𐀵𐀫𐀞
οδρυς	𐀃𐀉𐀬𐀸
οδρυϝει	𐀃𐀉𐀬𐀸
οδρυϝια	𐀃𐀉𐀬𐀹𐀊
οδρυϝιος	𐀃𐀉𐀬𐀹𐀊
οικετης	𐀡𐀯𐀐𐀳𐀩
οικος	𐀺𐀂𐀒𐀆
οιχαλαι	𐀃𐀏𐀨
οιχαλεαι	𐀃𐀏𐁉
οκυναϝος	𐀃𐀓𐀙𐀺
οκυναϝων	𐀃𐀓𐀙𐀺
ολπα	𐀃𐀞
ονατα	𐀃𐀙𐀲
ονατερες	𐀃𐀙𐀳𐀩
ονατον	𐀃𐀙𐀲
ονος	𐀃𐀜
ονυξ	𐀃𐀝𐀏
ονυχες	𐀃𐀝𐀏
οπι	𐀁𐀠
οπι	𐀃𐀠
οπιδεσμοι	𐀃𐀠𐀆𐀰𐀗
οπιθετηρες	𐀃𐀠𐀳𐀳𐀩
οπιιαφι	𐀃𐀠𐀂𐀊𐀠
οπικελεμνια	𐀃𐀠𐀐𐀩𐀖𐀛𐀊
οπικελεμνιαφι	𐀃𐀠𐀐𐀩𐀖𐀛𐀊
οπιλιμνιος	𐀃𐀠𐀪𐀖𐀛𐀍
οπισκαφεεϝες	𐀃𐀠𐀏𐀟𐀁𐀸
οπισυγος	𐀃𐀠𐀱𐀒
οπιτευχεευς	𐀃𐀠𐀳𐀄𐀐𐀁𐀄
οπιἁλα	𐀃𐀠𐁀𐀨
οπλα	𐀃𐀞
οπλιμνιος	𐀃𐀠𐀪𐀖𐀛𐀍
οπωποι	𐀃𐀡𐀦
οπωπω	𐀃𐀡𐀦
οργεωνες	𐀺𐀫𐀑𐀍𐀚𐀍
ορει	𐀃𐀩𐀂
ορεστας	𐀃𐀩𐀲
οριον	𐀺𐀺
ορμος	𐀃𐀗𐀠
ορμοφι	𐀃𐀗𐀠
ορνιθα	𐀃𐀛𐀴𐀀𐀠
ορνιθιαφι	𐀃𐀛𐀴𐀀𐀠
ορνις	𐀃𐀛𐀴𐀀𐀠
ορομενος	𐀃𐀫𐀕𐀜
ορος	𐀃𐀩𐀂
ορος	𐀺𐀺
ορτιναϝος	𐀃𐀴𐀙𐀺
ορτιναϝων	𐀃𐀴𐀙𐀺
ορυμανθος	𐀃𐀬𐀔𐀵
ορχα	𐀃𐀏
ορχομενευς	𐀃𐀒𐀕𐀚𐀄
ορχομενος	𐀁𐀒𐀕𐀜
ορω	𐀃𐀫𐀕𐀜
ορω	𐀃𐀹𐀆
οταν	𐀃𐀳
οτε	𐀃𐀳
ουδιδονσι	𐀃𐀄𐀇𐀈𐀯
ουδιδοντοι	𐀃𐀄𐀇𐀈𐀯
ουκε	𐀃𐀄𐀤
ους	𐀃𐀺𐀸
ουτε	𐀃𐀄𐀤
ουτερμις	𐀃𐀄𐀳𐀖
ουϝορζει	𐀃𐀄𐀺𐀽
οφειλη	𐀃𐀟𐀫
οφειλουσι	𐀃𐀟𐀫𐀯
οφειλω	𐀃𐀡𐀫
οφελονσα	𐀃𐀟𐀫𐀭
οφελονσι	𐀃𐀟𐀫𐀯
οφελοντας	𐀃𐀟𐀫𐀭
οφελοντες	𐀃𐀟𐀫𐀭
οφελος	𐀃𐀟𐀫
οφελτας	𐀃𐀟𐀲
οϝιδεται	𐀃𐀹𐀆𐀲𐀂
οϝιδετας	𐀃𐀹𐀆𐀲𐀂
οϝιτνος	𐀃𐀹𐀵𐀜
οϝιτονιοι	𐀃𐀹𐀵𐀛𐀍
οϝος	𐀃𐀺𐀸
οϝωϝεις	𐀃𐀺𐀸
παγχυλιων	𐀞𐀓𐁊
παιαϝονει	𐀞𐀊𐀺𐀚
παιαϝων	𐀞𐀊𐀺𐀚
πακτηρες	𐀞𐀐𐀳𐀩
παλαιος	𐀞𐀨𐀍
παλταια	𐀞𐀲𐀊
παλτον	𐀞𐀲𐀊
πανδαγευς	𐀞𐀅𐀋𐀄
πανδιων	𐀞𐀇𐀍
πανσα	𐀞𐀭
πανσαν	𐀞𐀭
πανσι	𐀞𐀯
πανσιθεοις	𐀞𐀯𐀳𐀃𐀂
παντεκτων	𐀞𐀳𐀒𐀵
παντες	𐀞𐀳
παρα	𐀞𐀫
παραιος	𐀞𐀨𐀍
παρο	𐀞𐀫
παρϝοργες	𐀞𐀺𐀐
πας	𐀞𐀳
πατας	𐀞𐀲
πατερ	𐀞𐀳
πεδα	𐀟𐀅
πεδιλα	𐀟𐀇𐀨
πεδϝεσσα	𐀟𐀆𐀸𐀭
πεκοτον	𐀟𐀒𐀵
πελεκευς	𐀟𐀩𐀐𐀄
πελιτας	𐀟𐀪𐀲
πεπιθμενοιο	𐀟𐀠𐀳𐀕𐀜𐀍
πεπιθμενος	𐀟𐀠𐀳𐀕𐀜𐀍
περιθοϝος	𐀟𐀪𐀵𐀺
περιμηδης	𐀟𐀪𐀕𐀆
περιτευς	𐀟𐀪𐀳𐀄
περυσινα	𐀟𐀬𐀯𐀝𐀷
περυσινο	𐀟𐀬𐀯𐀝𐀷
περυσινυϝο	𐀟𐀬𐀯𐀝𐀷
περυσινϝα	𐀟𐀬𐀯𐀝𐀷
πεταλος	𐀟𐀲𐀫
πετνιος	𐀟𐀵𐀛𐀍
πετνος	𐀟𐀵𐀜
πετονιος	𐀟𐀵𐀛𐀍
πετονος	𐀟𐀵𐀜
πετροποφι	𐀤𐀵𐀫𐀡𐀠
πετρωϝεις	𐀤𐀵𐀫𐀸
πιθος	𐀤𐀵
πικερευς	𐀠𐀐𐀩𐀄
πιπης	𐀠𐀠
πισϝατας	𐀠𐀭𐀷𐀲
πιτακευς	𐀠𐀲𐀐𐀄
πλευρων	𐀟𐀩𐀄𐀫𐀙𐀆
πλευρωνανδε	𐀟𐀩𐀄𐀫𐀙𐀆
πλευρωνιος	𐀟𐀩𐀄𐀫𐀛𐀍
πλουτευς	𐀡𐀫𐀄𐀳𐀄
πλωϝιστοιο	𐀡𐀫𐀹𐀵𐀍
πλωϝιστος	𐀡𐀫𐀹𐀵𐀍
πνεϝεντα	𐀟𐀚𐀸𐀲
ποδαργος	𐀡𐀅𐀒
ποδει	𐀡𐀆
ποικιλωνυχα	𐀡𐀑𐀫𐀝𐀏
ποιμενει	𐀡𐀕
ποιμενος	𐀡𐀕
ποιμην	𐀡𐀕
πολιϝος	𐀡𐀪𐀺
πολυβοτας	𐀡𐀬𐀦𐀲
πολυκαστος	𐀡𐀬𐀏𐀵
πολυποδει	𐀡𐀬𐀡𐀆
πολυπους	𐀡𐀬𐀡𐀆
ποντιλοι	𐀡𐀴𐀫
πορτις	𐀡𐀴𐀠
πορτιφι	𐀡𐀴𐀠
πορφυρεια	𐀡𐀢𐀩𐀊
πορφυριων	𐀡𐀢𐁊
ποσειδαονει	𐀡𐀮𐀅𐀃
ποσειδαων	𐀡𐀮𐀅𐀃
ποσι	𐀡𐀯
ποσιδαεια	𐀡𐀯𐀅𐀁𐀊
ποσιδαεϝες	𐀡𐀯𐀅𐀁𐀸
ποσιδαιγευς	𐀡𐀯𐀅𐀂𐀋𐀄
ποσιδαιον	𐀡𐀯𐀅𐀂𐀍
ποσικετερες	𐀡𐀯𐀐𐀳𐀩
ποτνειαιππεια	𐀡𐀴𐀛𐀊𐀂𐀤𐀀
ποτνια	𐀡𐀴𐀛𐀊
ποτνιαϝεια	𐀡𐀴𐀛𐀊𐀸𐀊
ποτνιαϝειος	𐀡𐀴𐀛𐀊𐀸𐀊
πους	𐀡𐀆
ποφι	𐀡𐀆
πρεσποτας	𐀟𐀩𐀦𐀲
πριετερ	𐀠𐀪𐀋𐀳
πριετερες	𐀠𐀪𐀋𐀳
πριετεσι	𐀠𐀪𐀋𐀳
προδυματες	𐀡𐀫𐀉𐀔𐀳
προεχης	𐀡𐀫𐀁𐀐
προκορετερες	𐀡𐀫𐀒𐀩𐀳𐀩
πρωτευς	𐀡𐀫𐀳𐀄
πτελεα	𐀟𐀳𐀩𐀷
πτελεϝας	𐀟𐀳𐀩𐀷
πτιλιοϝεσσα	𐀠𐀴𐁊𐀸𐀭
πτιλον	𐀠𐀴𐁊𐀸𐀭
πυγεσερος	𐀢𐀐𐀮𐀫
πυλος	𐀢𐀫
πυξελος	𐀢𐀐𐀮𐀫
πυξος	𐀢𐀒𐀰
πυρασος	𐀢𐀨𐀰
πυρατας	𐀢𐀨𐀲
πυραυθρον	𐀢𐀨𐀄𐀵𐀫
πωλος	𐀡𐀫
πωρος	𐀡𐀫
ραια	𐀨𐀊
ραμμενη	𐀁𐀨𐀟𐀕𐀙
ραπτερ	𐀨𐁇
ραπτριαι	𐀨𐀠𐀴𐁈
ριον	𐀪𐀍
ριονδε	𐀪𐀍
ροδοεν	𐀺𐀈𐀸
ροικος	𐀫𐀂𐀒
ροοϝα	𐀫𐀃𐀷
ρυνασος	𐀬𐀙𐀰
σαγηλευς	𐀭𐀐𐀩𐀄
σαγρευς	𐀭𐀐𐀩𐀄
σαλινουϝοντει	𐀭𐀪𐀝𐀺𐀳
σαμαρα	𐀭𐀔𐀨
σαμαριϝα	𐀭𐀔𐀪𐀷
σαρπιδες	𐀭𐀠𐀆
σασαμα	𐀭𐀭𐀔
σελινον	𐀮𐀪𐀜
σελινους	𐀭𐀪𐀝𐀺𐀳
σελινοφοντει	𐀭𐀪𐀝𐀺𐀳
σησαμη	𐀭𐀭𐀔
σητοιαι	𐀮𐀵𐀂𐀊
σιγαδυϝεις	𐀯𐀊𐀉𐀸
σιμα	𐀯𐀔
σιμακος	𐀯𐀔𐀒
σινουρος	𐀯𐀜𐀄𐀫
σιριοιο	𐀯𐀪𐀍𐀍
σιριος	𐀯𐀪𐀍𐀍
σιτοκορϝοι	𐀯𐀵𐀒𐀺
σιτον	𐀯𐀵
σιτοποτνια	𐀯𐀵𐀡𐀴𐀛𐀊
σιἁλος	𐀯𐁀𐀫
σκελεἁς	𐀐𐀩𐁀
σκελος	𐀐𐀩𐁀
σκοινος	𐀒𐀜
σμινθευς	𐀯𐀖𐀳𐀄
σουρος	𐀰𐀄𐀫
σοϝενοι	𐀰𐀸𐀜
σοϝενος	𐀰𐀸𐀜
σπαλαθρον	𐀣𐀨𐀵𐀫
σπερμα	𐀟𐀔
σπερμον	𐀟𐀔
σραπεδας	𐀭𐀨𐀟𐀅
σταθμος	𐀲𐀵𐀗
σταρταγευς	𐀲𐀲𐀐𐀄
στατηρες	𐀲𐀳𐀩
στατιποϝευς	𐀲𐀴𐀦𐀸𐀄
στομαργος	𐀵𐀔𐀒
στρατηγος	𐀲𐀲𐀐𐀄
στρυπτερια	𐀶𐀬𐁇𐀪𐀊
συβοτας	𐀱𐀦𐀲
συγριτα	𐀱𐀑𐀪𐀲
συδνικος	𐀱𐀇𐀛𐀒
συζα	𐀱𐀼
συκyα	𐀱𐀼
συκα	𐀱𐀼
συμπαν	𐀓𐀱𐀞
συν	𐀓𐀱
συριμος	𐀱𐀪𐀗
συρος	𐀱𐀫
συστροφη	𐀓𐀱𐀵𐀫𐀞
συϝεροϝιος	𐀱𐀸𐀫𐀹𐀍
σφαγιαναι	𐀞𐀑𐀊𐀙
σφαγιανιαι	𐀞𐀑𐀊𐀛𐀊
σφαγιανιοι	𐀞𐀑𐀊𐀛𐀊
σφακοσιοιο	𐀞𐀒𐀯𐀍𐀍
σφακοσιος	𐀞𐀒𐀯𐀍𐀍
σφακοϝεν	𐀞𐀒𐀸
σφακτηριαι	𐀭𐀞𐀐𐀳𐀪𐀊
σφακτρια	𐀭𐀞𐀐𐀳𐀪𐀊
σφεις	𐀟𐀂
ταλανσια	𐀲𐀨𐀯𐀊
ταμιευς	𐀲𐀖𐀋𐀄
τανιχος	𐀲𐀛𐀒
τανταλος	𐀲𐀲𐀫
ταρφα	𐀲𐀞
τεθρυϝες	𐀳𐀶𐀬𐀸
τεκτονες	𐀳𐀒𐀵𐀚
τελεσται	𐀳𐀩𐀲
τελεστας	𐀳𐀩𐀲
τελεσταων	𐀳𐀩𐀲
τελθος	𐀤𐀳𐀀
τελουρος	𐀳𐀬𐀫
τεμενος	𐀳𐀕𐀜
τερμινθια	𐀳𐀖𐀴𐀊
τερμινθος	𐀴𐀖𐀵
τερμινθωναγκος	𐀴𐀖𐀵𐀀𐀐𐀁
τετροποφι	𐀤𐀵𐀫𐀡𐀠
τετρωϝεις	𐀤𐀵𐀫𐀸
τετυχυϝοα	𐀳𐀶𐀓𐀺𐀀
τευχεα	𐀳𐀄𐀐𐀠
τευχεσφι	𐀳𐀄𐀐𐀠
τευχος	𐀳𐀄𐀐𐀠
τινϝασια	𐀴𐁅𐀯𐀊
τιρμινθος	𐀴𐀖𐀵
τοε	𐀵𐀁
τοιο	𐀵𐀍
τοιχοδομοι	𐀵𐀒𐀈𐀗
τοκευς	𐀵𐀐𐀄
τομε	𐀵𐀕
τονε	𐀵𐀕
τοξοτας	𐀵𐀒𐀰𐀲
τοξοϝοργος	𐀵𐀒𐀰𐀺𐀒
τοξϝοργος	𐀵𐀒𐀰𐀺𐀒
τορπεζα	𐀵𐀟𐀼
τορπιδει	𐀵𐀥𐀆
τορπιδεια	𐀵𐀥𐀆
τορπιδειος	𐀵𐀥𐀆
τορπιδϝεσσα	𐀵𐀥𐀆
τορπις	𐀵𐀥𐀆
τοσα	𐀵𐀭
τοσαδε	𐀵𐀭𐀆
τοσαι	𐀵𐀭
τοσοι	𐀵𐀰
τοσοιο	𐀵𐀭𐀆
τοσον	𐀵𐀰
τοσονε	𐀵𐀭𐀆
τοσοσδε	𐀵𐀭𐀆
τοσοσπας	𐀵𐀭𐀆
τοτον	𐀵𐀵
του	𐀵𐀍
τραπεζα	𐀵𐀟𐀼
τρια	𐀴𐀪𐀊
τριδαρος	𐀴𐀪𐀅𐀫
τριποδισκοι	𐀴𐀪𐀡𐀇𐀒
τριπους	𐀴𐀪𐀡
τριπως	𐀴𐀪𐀡
τρισηρωις	𐀴𐀪𐀮𐀫𐀁
τρισι	𐀴𐀪𐀊
τρισιρωει	𐀴𐀪𐀮𐀫𐀁
τριωϝεις	𐀴𐀪𐀍𐀸
τροπις	𐀵𐀥𐀆
τροπωτηρ	𐀁𐀵𐀫𐀣𐀲
τυλισια	𐀶𐀪𐀯𐀊
τυλισιος	𐀶𐀪𐀯𐀊
τυλισος	𐀶𐀪𐀰
τυλιτας	𐀶𐀪𐀲
τυριον	𐀶𐁊
τυχενευς	𐀶𐀐𐀚𐀄
υαλεια	𐀸𐀀𐀩𐀊
υαλειος	𐀸𐀀𐀩𐀊
υδρος	𐀄𐀈𐀫
υιος	𐀂𐀋𐀸
υλαιος	𐀄𐀨𐀍
υλαμνος	𐀄𐀨𐀗𐀜
υλευς	𐀄𐀩𐀄
υλιων	𐀄𐁊
υπο	𐀄𐀡
υριων	𐀄𐁊
υταιοιο	𐀄𐀲𐀍𐀍
υταιος	𐀄𐀲𐀍𐀍
υτανος	𐀄𐀲𐀜
υϝατας	𐀄𐀷𐀲
φαιστια	𐀞𐀂𐀴𐀊
φαιστιος	𐀞𐀂𐀴𐀊
φαιστος	𐀞𐀂𐀵
φαμι	𐀞𐀯
φαρμακον	𐀞𐀔𐀒
φαρϝεα	𐀞𐀸𐀀
φασγανα	𐀞𐀏𐀙
φασγιαναι	𐀞𐀑𐀊𐀙
φασγιανιαι	𐀞𐀑𐀊𐀛𐀊
φασγιανιοι	𐀞𐀑𐀊𐀛𐀊
φασιν	𐀞𐀯
φερειν	𐀟𐀩
φερομαι	𐀡𐀩𐀙
φημι	𐀞𐀯
φιαλη	𐀠𐁀𐀨
φιελαιαι	𐀠𐁀𐀨
φιλοϝεργος	𐀠𐀫𐀸𐀒
φιἁλαι	𐀠𐁀𐀨
φλιαι	𐀠𐀪𐀊𐀃
φλιαιων	𐀠𐀪𐀊𐀃
φοινικει	𐀡𐀛𐀐
φοινικια	𐀡𐀛𐀐𐀊
φοινικιος	𐀡𐀛𐀐𐀊
φορβειαι	𐀡𐀤𐀹𐀀
φορεϝιαι	𐀡𐀤𐀹𐀀
φορηναι	𐀡𐀩𐀙
φτενοι	𐁇𐀜
φυγεκλης	𐁆𐀐𐀥𐀪
φυγης	𐁆𐀐
φυλιαςαγρευς	𐁆𐁈𐀀𐀐𐀩𐀄
φυσιαρχος	𐁆𐀯𐀊𐀒
φυτερ	𐁆𐀳
φυτερια	𐁆𐀳𐀪𐀊
χαλκειαφι	𐀏𐀒
χαλκευς	𐀏𐀐𐀄
χαλκευσι	𐀏𐀐𐀄
χαλκηϝες	𐀏𐀐𐀄
χαλκια	𐀏𐀑𐀊
χαλκιος	𐀏𐀑𐀊
χαλκον	𐀏𐀒
χαλκος	𐀏𐀒
χανδαρος	𐀏𐀅𐀫
χαραδοϝατας	𐀏𐀨𐀈𐀷𐀲
χαραδρος	𐀏𐀨𐀈𐀫
χαρισευς	𐀏𐀪𐀮𐀄
χαρισιος	𐀏𐀪𐀯𐀍
χαροψ	𐀏𐀫𐀦
χαρυβδος	𐁀𐀬𐀺𐀳
χαυνος	𐀏𐀄𐀜
χευσπονδας	𐀐𐀄𐀡𐀅
χευσπονδεια	𐀐𐀄𐀡𐀅
χιτων	𐀑𐀵
χρυσος	𐀓𐀬𐀰
χρυσουργος	𐀓𐀬𐀰𐀺𐀒
χρυσοϝοργος	𐀓𐀬𐀰𐀺𐀒
ψελλος	𐀟𐀮𐀫
ψωρακος	𐀡𐀰𐀨𐀒
ψωρεια	𐀡𐀰𐀩𐀊
ψωρος	𐀡𐀰𐀫
ψωφρει	𐀡𐀰𐀟𐀩𐀂
ψωφρης	𐀡𐀰𐀟𐀩𐀂
ωνεομαι	𐀃𐀙𐀲
ωνοι	𐀃𐀜
ως	𐀍𐀈𐀰𐀯
ωφλον	𐀃𐀡𐀫
ϝανακτει	𐀷𐀙𐀏
ϝανακτερα	𐀷𐀙𐀏𐀳𐀨
ϝανακτερων	𐀷𐀙𐀏𐀳𐀨
ϝανακτος	𐀷𐀙𐀏
ϝαναξ	𐀷𐀙𐀏
ϝανασεϝια	𐀷𐀙𐀮𐀹𐀊
ϝανασεϝιος	𐀷𐀙𐀮𐀹𐀊
ϝανασος	𐀷𐀙𐀰
ϝανασσα	𐀷𐀙𐀭
ϝαναταιος	𐀷𐀙𐀲𐀍
ϝανιχος	𐀷𐀛𐀒
ϝανοιοϝορϝος	𐀷𐀜𐀍𐀺𐀺
ϝαπφαλοιο	𐀷𐀞𐀫𐀍
ϝαπφαλος	𐀷𐀞𐀫𐀍
ϝαστυ	𐀷𐀶
ϝαστυοχος	𐀷𐀶𐀃𐀒
ϝατος	𐀷𐀵
ϝεαλεια	𐀸𐀀𐀩𐀊
ϝεαλειος	𐀸𐀀𐀩𐀊
ϝεκπεζα	𐀸𐀟𐀼
ϝενδανευς	𐀸𐀅𐀚𐀄
ϝετος	𐀸𐀵
ϝεϝεσιοιο	𐀸𐀸𐀯𐀍𐀍
ϝεϝεσιος	𐀸𐀸𐀯𐀍𐀍
ϝεἁνος	𐀸𐁀𐀜
ϝιδε	𐀃𐀹𐀆
ϝιδουϝακος	𐀹𐀉𐀷𐀒
ϝιδοϝοιος	𐀹𐀈𐀺𐀂𐀍
ϝιδυλος	𐀹𐀉𐀫
ϝισειος	𐀹𐀮𐀍
ϝισυλος	𐀹𐀱𐀫
ϝιτιμιος	𐀹𐀴𐀖𐀍
ϝιτυλιος	𐀹𐀶𐀪𐀍
ϝιφινοος	𐀹𐀠𐀜𐀃
ϝοικονδε	𐀺𐀂𐀒𐀆
ϝοικος	𐀺𐀂𐀒𐀆
ϝοινος	𐀺𐀜
ϝοινωψ	𐀺𐀜𐀦𐀰
ϝοκευς	𐀺𐀤𐀸
ϝοκεϝει	𐀺𐀤𐀸
ϝονευς	𐀺𐀚𐀸
ϝονεϝει	𐀺𐀚𐀸
ϝονοκευς	𐀺𐀜𐀤𐀷
ϝονοκεϝαν	𐀺𐀜𐀤𐀷
ϝονοκεϝει	𐀺𐀜𐀤𐀷
ϝοραϝεσσα	𐀺𐀨𐀸𐀭
ϝοργιονειος	𐀺𐀫𐀑𐀍𐀚𐀍
ϝοργιονες	𐀺𐀫𐀑𐀍𐀚𐀍
ϝορδοϝεν	𐀺𐀈𐀸
ϝορζομενα	𐀺𐀿𐀕𐀙
ϝορζομενος	𐀺𐀿𐀕𐀙
ϝορζοντες	𐀺𐀿
ϝορζων	𐀺𐀿
ϝορϝος	𐀺𐀺
ϝοχα	𐀺𐀏
ϝρινειος	𐀹𐀪𐀚𐀍
ϝρινος	𐀹𐀪𐀜
ϝρονεια	𐀺𐀫𐀚𐀊
ϝρυμαι	𐀄𐀬𐀵
ϝρυντοι	𐀄𐀬𐀵
ϝρυπιαιοι	𐀄𐀬𐀠𐀊𐀍
ἁλοσυδωρφι	𐁀𐀫𐀄𐀈𐀠
ἁρυϝοθεν	𐁀𐀬𐀺𐀳
ἁτερος	𐁀𐀳𐀫
